Hector -- Andromache
Achilles -- Athene
Zeus -- Hera
Ares -- Aphrodite
Patroclus -- Briseis
Heracles -- Hesione
Odysseus -- Chryseis
Apollo -- Artemis
Diomedes -- Iphianassa
Paris -- Helen
Machaon -- Hecamede
Meriones -- Theano
Poseidon -- Rhea
Antilochus -- Enyo
Polydamus -- Eeriboea
Priam -- Hecuba
Zephyr -- Anteia
Sarpedon -- Laodameia
Iris -- Aethra
Hephaestus -- Thetis
Glaucus -- Laodice
Talthybius -- Eurynome
Automedon -- Periboea
Peleus -- Polydora
Hermes -- Leto
Eurypylus -- Charis
Hades -- Althea
Bellerophon -- Philonoe
Tydeus -- Deipyle
Agenor -- Dia
Idaeus -- Cassandra
Acamas -- Cleopatra
Sthenelus -- Europa
Deiphobus -- Marpessa
Menestheus -- Demeter
Nestor -- Agamede
Thrasymedes -- Semele
Agamemnon -- Alcmene
Thoas -- Ariadne
Great-Ajax -- Danae
Sleep -- Tethys
Cebriones -- Ate
Oeneus -- Dione
Peneleos -- Astyoche
Lesser-Ajax -- Abarbarea
Idomeneus -- Hippodameia
Asteropaeus -- Polymele
Laomedon -- Laodice
Helenus -- Chrysothemis
Phoenix -- Clytia
Menelaus -- Chryses
Aeneas -- Astyocheia
Leonteus -- Medesicaste
Meges -- Eileithyia
Euryalus -- Eos
Polypoetes -- Niobe
Anchises -- Night
Strife -- Iphis
Eumelus -- Clymene
Teucer -- Hypsipyle
Pandarus -- Laothoe
Xanthus -- Themis
